########22######
########**######
########**######
########**######
########**######
######******####
######******####
######********##
######********##
####**********##
####**********##
######*********#
######*********#
######******####
######******####
######******####
######******####
#***********####
####********####
####*******1####
################
################
################
################