#############
#############
####**#*###**
***#######***
******2******
*************
*************
*************
*************
######1######